╔══════════╗
║**********║
║**********║
║**X*******║
║**********║
║**********║
╚══════════╝