╔══════════╗
║X*********║
║**********║
║**********║
║**********║
║**********║
╚══════════╝