╔══════════╗
║**********║
║**********║
║****X*****║
║**********║
║**********║
╚══════════╝