╔══════════╗
║**********║
║*X********║
║**********║
║**********║
║**********║
╚══════════╝