╔══════════╗
║**********║
║**********║
║**********║
║**********║
║******X***║
╚══════════╝