╔══════════╗
║**********║
║**********║
║**********║
║*****X****║
║**********║
╚══════════╝