╔══════════╗
║**********║
║**********║
║**********║
║******X***║
║**********║
╚══════════╝