╔══════════╗
║**********║
║**********║
║***X******║
║**********║
║**********║
╚══════════╝