╔══════════╗
║*X********║
║**********║
║**********║
║**********║
║**********║
╚══════════╝