╔══════════╗
║**********║
║**********║
║**********║
║**********║
║*******X**║
╚══════════╝